0install	github.com/0install/0install
aacplus	github.com/savonet/ocaml-aacplus
abella	github.com/abella-prover/abella
absolute	github.com/mpelleau/AbSolute
accessor	github.com/janestreet/accessor
accessor_async	github.com/janestreet/accessor_async
accessor_base	github.com/janestreet/accessor_base
accessor_core	github.com/janestreet/accessor_core
acgtk	gitlab.inria.fr/ACG/dev/ACGtk
acme	github.com/raphael-proust/ocaml-acme
acpc	github.com/UnixJunkie/ACPC
advi	github.com/diremy/advi
afl-persistent	github.com/stedolan/ocaml-afl-persistent
ago	github.com/lindig/ocaml-ago
agrid	github.com/ocamlpro/agrid
ahrocksdb	github.com/ahrefs/ocaml-ahrocksdb
aifad	github.com/mmottl/aifad
alba	github.com/hbr/albatross
albatross	github.com/roburio/albatross
alberto	github.com/selectel/alberto
alcotest	github.com/mirage/alcotest
alg_structs	github.com/shonfeder/alg_structs
aliases	github.com/besport/ocaml-aliases
alsa	github.com/savonet/ocaml-alsa
alt-ergo	github.com/OCamlPro/alt-ergo
amf	github.com/briancaine/ocaml-amf
amqp-client	github.com/andersfugmann/amqp-client
ancient	github.com/UnixJunkie/ocaml-ancient
angstrom	github.com/inhabitedtype/angstrom
annot	github.com/avsm/ocaml-annot
ansi-parse	github.com/jdjakub/ansi-parse
ANSITerminal	github.com/Chris00/ANSITerminal
anthill	github.com/martindemello/anthill
anycache	gitlab.com/edwintorok/ocaml-anycache
ao	github.com/savonet/ocaml-ao
aperf	github.com/philipdexter/aperf
apero-core	github.com/atolab/apero-core
apero-net	github.com/atolab/apero-net
apero-time	github.com/atolab/apero-time
apron	github.com/antoinemine/apron
apronext	github.com/ghilesZ/apronext
arakoon	github.com/openvstorage/arakoon
archetype	github.com/edukera/archetype-lang
archi	github.com/anmonteiro/archi
archsat	scm.gforge.inria.fr/anonscm/git/archsat/archsat
argon2	github.com/Khady/ocaml-argon2
arp	github.com/mirage/arp
art	github.com/dinosaure/art
asak	github.com/nobrakal/asak
ascii85	github.com/lindig/ascii85
asetmap	erratique.ch/repos/asetmap
ask	github.com/uzh/ask
asl	github.com/mirage/ocaml-asl
asli	github.com/alastairreid/asl-interpreter
asn1-combinators	github.com/mirleft/ocaml-asn1-combinators
assertions	github.com/bennn/assertions
assimp	github.com/def-lkb/assimp
astring	erratique.ch/repos/astring
async	github.com/janestreet/async
async_core	github.com/janestreet/async_core
async_durable	github.com/janestreet/async_durable
async_extended	github.com/janestreet/async_extended
async_extra	github.com/janestreet/async_extra
async_find	github.com/janestreet/async_find
async_graphics	github.com/lpw25/async_graphics
async_inotify	github.com/janestreet/async_inotify
iasync_interactive	github.com/janestreet/async_interactive
async_js	github.com/janestreet/async_js
async_kernel	github.com/janestreet/async_kernel
async-mvar	github.com/rgrinberg/async-mvar
async_parallel	github.com/janestreet/async_parallel
async_rpc_kernel	github.com/janestreet/async_rpc_kernel
async_sendfile	github.com/janestreet/async_sendfile
async_shell	github.com/janestreet/async_shell
async_smtp	github.com/janestreet/async_smtp
async_ssl	github.com/janestreet/async_ssl
async_udp	github.com/janestreet/async_udp
async_unix	github.com/janestreet/async_unix
async-uri	github.com/vbmithr/async-uri
async_websocket	github.com/janestreet/async_websocket
async-zmq	github.com/rgrinberg/async-zmq
atable	github.com/ocamlpro/atable
atd	github.com/ahrefs/atd
atd2cconv	github.com/smondet/atd2cconv
atdj	github.com/esperco/atdj
augeas	git.annexia.org/ocaml-augeas
avroc	github.com/sidharthkuruvila/ocaml-avroc
awa	github.com/mirage/awa-ssh
aws	github.com/inhabitedtype/ocaml-aws
aws-s3	github.com/andersfugmann/aws-s3
azblob	github.com/kkazuo/azblob
azure-cosmos-db	bitbucket.org/knaack/azure-cosmos-db
b0	erratique.ch/repos/b0
baardskeerder	github.com/Incubaid/baardskeerder
bag	github.com/backtracking/bag
balancer	github.com/xnukernpoll/ocaml-balancers
bamboo	github.com/pirapira/bamboo
bap	github.com/BinaryAnalysisPlatform/bap/
bap-emacs-dot	github.com/ivg/emacs-dot/
bap-emacs-mode	github.com/fkie-cad/bap-mode
bap-ida-python	github.com/BinaryAnalysisPlatform/bap-ida-python/
bap-saluki	github.com/BinaryAnalysisPlatform/bap-plugins/
bap-server	github.com/BinaryAnalysisPlatform/bap-server/
bap-veri	github.com/BinaryAnalysisPlatform/bap-veri/
bark	github.com/justinlubin/bark
base	github.com/janestreet/base
base58	github.com/sylvarant/base58
base64	github.com/mirage/ocaml-base64
base_bigstring	github.com/janestreet/base_bigstring
base_quickcheck	github.com/janestreet/base_quickcheck
bastet	github.com/Risto-Stevcev/bastet
bastet_async	github.com/Risto-Stevcev/bastet-async
bastet_lwt	github.com/Risto-Stevcev/bastet-lwt
batch_jaro_winkler	github.com/dbousque/batch_jaro_winkler
batsat	github.com/c-cube/batsat-ocaml
batsh	github.com/BYVoid/Batsh
batteries	github.com/ocaml-batteries-team/batteries-included
bau	github.com/rleonid/bau
bear	github.com/hcarty/bear
bech32	github.com/vbmithr/ocaml-bech32
bechamel	github.com/dinosaure/bechamel
beluga	github.com/Beluga-lang/Beluga
benchmark	github.com/Chris00/ocaml-benchmark
benchpress	github.com/sneeuwballen/benchpress
bencode	github.com/rgrinberg/bencode
bentov	github.com/barko/bentov
BetterErrors	github.com/chenglou/BetterErrors
bheap	github.com/backtracking/bheap
bibtex2html	github.com/backtracking/bibtex2html
bigarray-compat	github.com/mirage/bigarray-compat
bigarray-overlap	github.com/dinosaure/overlap
bignum	github.com/janestreet/bignum
bigstring	github.com/c-cube/ocaml-bigstring
bigstringaf	github.com/inhabitedtype/bigstringaf
bimage	github.com/zshipko/ocaml-bimage
binaryen	github.com/grain-lang/binaryen.ml
bindlib	github.com/rlepigre/ocaml-bindlib
biniou	github.com/mjambon/biniou
binning	github.com/pveber/binning
bin_prot	github.com/janestreet/bin_prot
biocaml	github.com/biocaml/biocaml
bisect_ppx	github.com/aantron/bisect_ppx
bisect_ppx-ocamlbuild	github.com/aantron/bisect_ppx-ocamlbuild
bisect-summary	github.com/lindig/bisect-summary
bistro	github.com/pveber/bistro
bitcoin	github.com/darioteixeira/ocaml-bitcoin
bitcoinml	github.com/dakk/bitcoinml
bitmasks	github.com/metastack/bitmasks
bitstring	github.com/xguerin/bitstring
bitv	github.com/backtracking/bitv
bjack	github.com/savonet/ocaml-bjack
blahcaml	github.com/darioteixeira/blahcaml
blake2	gitlab.com/nomadic-labs/ocaml-blake2
blake3	github.com/proof-ninja/ocaml-blake3
bloomf	github.com/mirage/bloomf
bls12-381	gitlab.com/dannywillems/ocaml-bls12-381
bn128	github.com/runtimeverification/bn128-ml
bnfgen	github.com/dmbaturin/bnfgen
bogue	github.com/sanette/bogue
bonsai	github.com/janestreet/bonsai
bookaml	github.com/darioteixeira/bookaml
boomerang	github.com/SolomonAduolMaina/boomerang
bpf	github.com/ygrek/ocaml-bpf
bracetax	github.com/smondet/bracetax
broken	github.com/michipili/broken
brotli	github.com/fxfactorial/reasonml-brotli
brozip	github.com/fxfactorial/brozip
brr	erratique.ch/repos/brr
bsbnative	github.com/bucklescript/bucklescript
bsdowl	github.com/michipili/bsdowl
bson2	github.com/nosman/Bson2
bst	github.com/UnixJunkie/bisec-tree
buffer-pool	github.com/cjen1/buffer-pool
build_path_prefix_map	gitlab.com/gasche/build_path_prefix_map
bulletml	github.com/emillon/bulletml
bun	github.com/yomimono/ocaml-bun
bwrap	github.com/Chris00/ocaml-bwrap
bytearray	github.com/UnixJunkie/bytearray
bytepdf	github.com/Drup/bytepdf
c3	github.com/djs55/ocaml-c3
ca-certs	github.com/mirage/ca-certs
ca-certs-nss	github.com/mirage/ca-certs-nss
cairo2	github.com/Chris00/ocaml-cairo
calculon	github.com/c-cube/calculon
calendar	github.com/ocaml-community/calendar
calendars	github.com/geneweb/calendars
callipyge	github.com/oklm-wsh/callipyge
camelot	github.com/upenn-cis1xx/camelot
camels	github.com/yomimono/camels
camelsnakekebab	github.com/swuecho/camelsnakekebab
caml2html	github.com/mjambon/caml2html
camlbz2	gitlab.com/irill/camlbz2
camlhighlight	github.com/darioteixeira/camlhighlight
camlidl	github.com/xavierleroy/camlidl
camlimages	gitlab.com/camlspotter/camlimages
caml-mode	github.com/ocaml/ocaml
camlon	gitlab.com/camlspotter/camlon
camlp4	github.com/camlp4/camlp4
camlp5	github.com/camlp5/camlp5
camltc	github.com/toolslive/camltc
camomile	github.com/yoriyuki/Camomile
camyll	github.com/alan-j-hu/camyll
capnp	github.com/capnproto/capnp-ocaml
capnp-rpc	github.com/mirage/capnp-rpc
captureio	github.com/sylvarant/captureio
caqti	github.com/paurkedal/ocaml-caqti
caradoc	github.com/ANSSI-FR/caradoc
carton	github.com/mirage/ocaml-git
catala	github.com/CatalaLang/catala
cbat-explicit-edge	github.com/draperlaboratory/cbat_tools
cca	github.com/codinuum/cca
cconv	github.com/c-cube/cconv
ccss	github.com/darioteixeira/ccss
cdrom	github.com/xapi-project/cdrom
certify	github.com/yomimono/ocaml-certify
cf	github.com/mirage/ocaml-cf
cfg	github.com/mmottl/cfg
cfgen	github.com/dmbaturin/bnfgen
cfstream	github.com/biocaml/cfstream
cgi	github.com/rixed/ocaml-cgi
cgroups	github.com/Gbury/ocaml-cgroups
chacha	github.com/abeaumont/ocaml-chacha
channel	github.com/mirage/mirage-channel
charrua	github.com/mirage/charrua
charrua-core	github.com/mirage/charrua-core
chartjs	github.com/monstasat/chartjs-ocaml
chase	github.com/ramsdell/chase
checkseum	github.com/mirage/checkseum
choice	github.com/c-cube/choice
cinaps	github.com/ocaml-ppx/cinaps
clangml	gitlab.inria.fr/memcad/clangml
clangml-transforms	gitlab.inria.fr/memcad/clangml-transforms
clap	github.com/rbardou/clap
clarity	github.com/IndiscriminateCoding/clarity
clarity-lang	github.com/weavery/clarity.ml
clim	github.com/Ninjapouet/clim
cloudi	github.com/CloudI/cloudi_api_ocaml
cmarker	github.com/pablo-meier/ocaml-cmark
cmdtui	gitlab.com/edwintorok/cmdtui
coclobas	github.com/hammerlab/coclobas
codept	github.com/Octachron/codept
cohttp	github.com/mirage/ocaml-cohttp
coin	github.com/mirage/coin
colombe	github.com/mirage/colombe
color	github.com/anuragsoni/color
color-brewery	github.com/Chris00/color_brewery
combinat	github.com/jfeser/combinat
combine	github.com/backtracking/combine
comby	github.com/comby-tools/comby
command_rpc	github.com/janestreet/command_rpc
commonjs_of_ocaml	github.com/angrylawyer/commonjs_of_ocaml
comparelib	github.com/janestreet/comparelib
conduit	github.com/mirage/ocaml-conduit
conex	github.com/hannesm/conex
conf-capnproto	github.com/capnproto/capnproto
conf-gobject-introspection	gitlab.gnome.org/GNOME/gobject-introspection
configuration	github.com/michipili/configuration
configurator	github.com/janestreet/configurator
conf-libpcre	github.com/mmottl/pcre-ocaml
conf-libudev	github.com/systemd/systemd
conf-netsnmp	www.github.com/stevebleazard/ocaml-conf-netsnmp
conf-numa	www.github.com/stevebleazard/ocaml-conf-numa
conformist	github.com/oxidizing/conformist
conf-postgresql	github.com/mmottl/postgresql-ocaml
conf-protoc	github.com/protocolbuffers/protobuf
conf-qt	github.com/Kakadu/lablqml
conf-secp256k1	github.com/dakk/conf-secp256k1
conf-sqlite3	github.com/mmottl/sqlite3-ocaml
containers	github.com/c-cube/ocaml-containers
cookie	github.com/ulrikstrid/ocaml-cookie
cookies	github.com/lemaetech/cookies
coq	github.com/coq/coq
coq-of-ocaml	github.com/clarus/coq-of-ocaml
coq-serapi	github.com/ejgallego/coq-serapi
cordova	github.com/dannywillems/ocaml-cordova
cordova-plugin-fcm	github.com/dannywillems/ocaml-cordova-plugin-fcm
cordova-plugin-file	github.com/dannywillems/ocaml-cordova-plugin-file
cordova-plugin-push-notifications	github.com/dannywillems/ocaml-cordova-plugin-push
cordova-plugin-sms	github.com/dannywillems/ocaml-cordova-plugin-sms
core	github.com/janestreet/core
core_bench	github.com/janestreet/core_bench
corecount	github.com/fxfactorial/ocaml-corecount
core_extended	github.com/janestreet/core_extended
core_kernel	github.com/janestreet/core_kernel
core_profiler	github.com/janestreet/core_profiler
cosovo	github.com/barko/cosovo
cow	github.com/mirage/ocaml-cow
cowabloga	github.com/mirage/cowabloga
cpm	github.com/UnixJunkie/cpmlib
cppo	github.com/ocaml-community/cppo
cpu	github.com/UnixJunkie/cpu
cpuid	github.com/pqwy/cpuid
craml	github.com/realworldocaml/craml
crc	github.com/xapi-project/ocaml-crc
crdt-ml	github.com/ergl/crdt-ml
crlibm	github.com/Chris00/ocaml-crlibm
crowbar	github.com/stedolan/crowbar
crunch	github.com/mirage/ocaml-crunch
cry	github.com/savonet/ocaml-cry
cryptohash	github.com/fdopen/cryptohash
csexp	github.com/ocaml-dune/csexp
css-parser	github.com/astrada/ocaml-css-parser
cstruct	github.com/mirage/ocaml-cstruct
csv	github.com/Chris00/ocaml-csv
csvfields	github.com/janestreet/csvfields
csvprovider	github.com/nv-vn/OCamlCsvProvider
ctypes-build	github.com/yallop/ocaml-ctypes-build
ctypes-zarith	github.com/fdopen/ctypes-zarith
cubicle	github.com/cubicle-model-checker/cubicle
cudf	scm.gforge.inria.fr/anonscm/git/cudf/cudf
cumulus	github.com/paurkedal/ocaml-cumulus
curly	github.com/rgrinberg/curly
current	github.com/ocurrent/ocurrent
current_ocluster	github.com/ocurrent/ocluster
curses	github.com/mbacarella/curses
curve-sampling	github.com/Chris00/ocaml-curve-sampling
custom_printf	github.com/janestreet/custom_printf
cviode	github.com/mseri/ocaml-cviode
cwe_checker	github.com/fkie-cad/cwe_checker
d3	github.com/seliopou/ocaml-d3
daft	github.com/UnixJunkie/daft
data-encoding	gitlab.com/nomadic-labs/data-encoding
dataframe	github.com/LaurentMazare/ocaml-dataframe
datakit	github.com/moby/datakit
daypack-lib	github.com/daypack-dev/daypack-lib
dbf	github.com/pveber/dbf
dbm	github.com/ocaml/dbm
dead_code_analyzer	github.com/LexiFi/dead_code_analyzer
debian-formats	github.com/gildor478/ocaml-debian-formats
decimal	github.com/yawaramin/ocaml-decimal
decoders	github.com/mattjbray/ocaml-decoders
decompress	github.com/mirage/decompress
dedukti	github.com/Deducteam/Dedukti
delimited_parsing	github.com/janestreet/delimited_parsing
depyt	github.com/samoht/depyt
deriving	github.com/ocsigen/deriving
dht	www.github.com/nojb/ocaml-dht
diet	github.com/mirage/ocaml-diet
digestif	github.com/mirage/digestif
directories	github.com/ocamlpro/directories
dirsift	github.com/darrenldl/dirsift
disml	gitlab.com/Mishio595/disml
dispatch	github.com/inhabitedtype/ocaml-dispatch
distributed	github.com/essdotteedot/distributed
distwit	github.com/let-def/distwit
diy	github.com/herd/herdtools7
dkim	github.com/dinosaure/ocaml-dkim
dlm	github.com/xapi-project/ocaml-dlm
dns	github.com/mirage/ocaml-dns
dns-forward	github.com/mirage/ocaml-dns-forward
dnssd	github.com/mirage/ocaml-osx-dnssd
docker-api	github.com/Chris00/ocaml-docker
dockerfile	github.com/avsm/ocaml-dockerfile
docteur	github.com/dinosaure/docteur
dog	github.com/samoht/dog
doi2bib	github.com/mseri/doi2bib
dokeysto	github.com/UnixJunkie/dokeysto
dolmen	github.com/Gbury/dolmen
dolog	github.com/UnixJunkie/dolog
domain-name	github.com/hannesm/domain-name
dotenv	github.com/thatportugueseguy/ocaml-dotenv
merlin	github.com/ocaml/merlin
down	erratique.ch/repos/down
DrawGrammar	github.com/jacquev6/DrawGrammar
dream	github.com/aantron/dream
drom	github.com/ocamlpro/drom
dropbox	github.com/Chris00/ocaml-dropbox
dryunit	github.com/gersonmoraes/dryunit
dsfo	github.com/rleonid/dsfo
dssi	github.com/savonet/ocaml-dssi
dtoa	github.com/flowtype/ocaml-dtoa
dtools	github.com/savonet/ocaml-dtools
dual	github.com/drjdn/ocaml_dual
duff	github.com/mirage/duff
dum	github.com/mjambon/dum
dumpast	github.com/samoht/ocaml-dumpast
dune	github.com/ocaml/dune
dune-deps	github.com/mjambon/dune-deps
dune-release	github.com/ocamllabs/dune-release
dune_watch	gitlab.com/camlspotter/dune_watch
duppy	github.com/savonet/ocaml-duppy
duration	github.com/hannesm/duration
earley	github.com/rlepigre/ocaml-earley
earley-ocaml	github.com/rlepigre/ocaml-earley-ocaml
earlybird	github.com/hackwaly/ocamlearlybird
easy-format	github.com/mjambon/easy-format
easy_logging	github.com/sapristi/easy_logging
easy_xlsx	github.com/brendanlong/ocaml-ooxml
ecaml	github.com/janestreet/ecaml
edn	github.com/prepor/ocaml-edn
eigen	github.com/owlbarn/eigen
either	github.com/mirage/either
elasticsearch-cli	github.com/cyborgize/es-cli
electrod	github.com/grayswandyr/electrod
electrumAnalyzer	github.com/grayswandyr/electrumAnalyzer
elina	github.com/eth-srl/ELINA
eliom	github.com/ocsigen/eliom
elpi	github.com/LPCIC/elpi
email_message	github.com/janestreet/email_message
embedded_ocaml_templates	github.com/EmileTrotignon/embedded_ocaml_templates
emile	github.com/dinosaure/emile
emoji	github.com/fxfactorial/ocaml-emoji
encore	github.com/mirage/encore
enumerate	github.com/janestreet/enumerate
enumerators	github.com/cryptosense/enumerators
eqaf	github.com/mirage/eqaf
erlang	github.com/AbstractMachinesLab/caramel
esgg	github.com/ahrefs/esgg
ethernet	github.com/mirage/ethernet
expect	github.com/gildor478/ocaml-expect
expect_test_helpers	github.com/janestreet/expect_test_helpers
expect_test_helpers_async	github.com/janestreet/expect_test_helpers_async
expect_test_helpers_core	github.com/janestreet/expect_test_helpers_core
expect_test_helpers_kernel	github.com/janestreet/expect_test_helpers_kernel
extunix	github.com/ygrek/extunix
ez_api	github.com/ocamlpro/ez_api
ez_cmdliner	github.com/ocamlpro/ez_cmdliner
ez_config	github.com/ocamlpro/ez_config
ez_file	github.com/ocamlpro/ez_file
ezgzip	github.com/hcarty/ezgzip
ez_hash	github.com/OcamlPro/ocaml-solidity
ezirmin	github.com/kayceesrk/ezirmin
ezjs_ace	github.com/ocamlpro/ezjs_ace
ezjs_blockies	github.com/ocamlpro/ezjs_blockies
ezjs_cleave	github.com/ocamlpro/ezjs_cleave
ezjs_crypto	github.com/ocamlpro/ezjs_crypto
ezjs_cytoscape	github.com/ocamlpro/ezjs_cytoscape
ezjs_d3pie	github.com/ocamlpro/ezjs_d3pie
ezjs_extension	github.com/ocamlpro/ezjs_extension
ezjs_fetch	github.com/ocamlpro/ezjs_fetch
ezjs_idb	github.com/ocamlpro/ezjs_idb
ezjs_jquery	github.com/ocamlpro/ezjs_jquery
ezjs_min	github.com/ocamlpro/ezjs_min
ezjs_odometer	github.com/ocamlpro/ezjs_odometer
ezjsonm	github.com/mirage/ezjsonm
ezjs_push	github.com/ocamlpro/ezjs_push
ezjs_qrcode	github.com/ocamlpro/ezjs_qrcode
ezjs_recaptcha	github.com/ocamlpro/ezjs_recaptcha
ezjs_timeline	github.com/ocamlpro/ezjs_timeline
ez_opam_file	github.com/ocamlpro/ez_opam_file
ez_pgocaml	github.com/ocamlpro/ez_pgocaml
ezresto	gitlab.com/nomadic-labs/resto
ezsqlite	github.com/zshipko/ocaml-ezsqlite
ez_subst	github.com/ocamlpro/ez_subst
ezxenstore	github.com/xapi-project/ezxenstore
ezxmlm	github.com/mirage/ezxmlm
faad	github.com/savonet/ocaml-faad
facebook-sdk	github.com/CREATe-centre/sociaml-facebook-api
facteur	github.com/dinosaure/facteur
fadbadml	github.com/fadbadml-dev/FADBADml
faraday	github.com/inhabitedtype/faraday
farfadet	github.com/oklm-wsh/Farfadet
fat-filesystem	github.com/mirage/ocaml-fat
fdkaac	github.com/savonet/ocaml-fdkaac
fd-send-recv	github.com/xapi-project/ocaml-fd-send-recv
feat	gitlab.inria.fr/fpottier/feat
febusy	gitlab.com/smondet/febusy
ff	gitlab.com/dannywillems/ocaml-ff
ffmpeg	github.com/savonet/ocaml-ffmpeg
fftw3	github.com/Chris00/fftw-ocaml
fiat-p256	github.com/mirage/fiat
fieldslib	github.com/janestreet/fieldslib
fileutils	github.com/gildor478/ocaml-fileutils
finch	github.com/roddyyaga/finch
findlib_top	github.com/janestreet/findlib_top
fix	gitlab.inria.fr/fpottier/fix
flac	github.com/savonet/ocaml-flac
flex-array	github.com/backtracking/flex-array
flock	github.com/simonjbeaumont/ocaml-flock
flow	github.com/facebook/flow
fluent-logger	github.com/komamitsu/fluent-logger-ocaml
fmlib	github.com/hbr/fmlib
fmt	erratique.ch/repos/fmt
fpath	erratique.ch/repos/fpath
frama-c-base	github.com/Frama-C/Frama-C-snapshot
frama-c-metacsl	git.frama-c.com/pub/meta
freetds	github.com/kennknowles/ocaml-freetds
frei0r	github.com/savonet/ocaml-frei0r
frenetic	github.com/frenetic-lang/frenetic
FrontC	github.com/BinaryAnalysisPlatform/FrontC
fsevents	github.com/mirage/ocaml-fsevents
fsml	github.com/jserot/fsml
fstreams	github.com/tel/ocaml-fstreams
functoria	github.com/mirage/functoria
funfields	github.com/fccm/ocaml-funfields
future	github.com/solvuu/future
gamepad	github.com/emillon/gamepad_of_ocaml
gammu	github.com/Chris00/ocaml-gammu
gapi-ocaml	github.com/astrada/gapi-ocaml
gappa	gitlab.inria.fr/gappa/gappa
gasoline	github.com/michipili/gasoline
gavl	github.com/savonet/ocaml-gavl
gd	github.com/savonet/gd4o
gdal	github.com/hcarty/ocaml-gdal
gdbprofiler	github.com/copy/gdbprofiler
gemini	github.com/struktured/ocaml-gemini
gen	github.com/c-cube/gen
gen-bs	github.com/0zat/gen-bs
General	github.com/jacquev6/General
gen_js_api	github.com/LexiFi/gen_js_api
genprint	github.com/progman1/genprintlib
genspio	github.com/hammerlab/genspio
genspir	github.com/UnixJunkie/genspir
gensqlite	github.com/j0sh/ocaml-gensqlite
getopts	github.com/michipili/getopts
gettext	github.com/gildor478/ocaml-gettext
github	github.com/mirage/ocaml-github
github-hooks	github.com/dsheets/ocaml-github-hooks
glfw-ocaml	github.com/SylvainBoilard/GLFW-OCaml
glical	github.com/pw374/glical
glMLite	github.com/fccm/glMLite
glpk	github.com/smimram/ocaml-glpk
gluten	github.com/anmonteiro/gluten
gmap	github.com/hannesm/gmap
gmp	github.com/mirage/ocaml-gmp
gnuplot	github.com/c-cube/ocaml-gnuplot
gobba	github.com/0x0f0f0f/gobba
gobject-introspection	github.com/cedlemo/OCaml-GObject-Introspection
goblint	github.com/goblint/analyzer
goblint-cil	github.com/goblint/cil/
google-drive-ocamlfuse	github.com/astrada/google-drive-ocamlfuse
gopcaml-mode	gitlab.com/gopiandcode/gopcaml-mode
gpr	github.com/mmottl/gpr
gpx	github.com/rundat/ocaml-gpx
gr	github.com/mseri/ocaml-gr
grain_wasm_spec	github.com/grain-lang/wasm-spec
graphics	github.com/ocaml/graphics
graphql	github.com/andreas/ocaml-graphql-server
graphql_ppx	github.com/reasonml-community/graphql-ppx
gremlin	github.com/bramford/ocaml-gremlin
grenier	github.com/let-def/grenier
gsl	github.com/mmottl/gsl-ocaml
gstreamer	github.com/savonet/ocaml-gstreamer
GT	github.com/JetBrains-Research/GT
GuaCaml	gitlab.com/boreal-ldd/guacaml
gufo	github.com/Piervit/gufo
h2	github.com/anmonteiro/ocaml-h2
hack_parallel	github.com/rvantonder/hack_parallel
hacl	gitlab.com/nomadic-labs/ocaml-hacl
hacl-star	github.com/project-everest/hacl-star
hacl_x25519	github.com/mirage/hacl
hamt	github.com/rgrinberg/ocaml-hamt
hardcaml	github.com/janestreet/hardcaml
hardcaml-affirm	github.com/ujamjar/hardcaml-affirm
hardcaml-bloop	github.com/ujamjar/hardcaml-bloop
hardcaml-examples	github.com/ujamjar/hardcaml-examples
hardcaml-framework	github.com/ujamjar/hardcaml-framework
hardcaml-llvmsim	github.com/ujamjar/hardcaml-llvmsim
hardcaml-reedsolomon	github.com/ujamjar/hardcaml-reedsolomon
hardcaml-vpi	github.com/ujamjar/hardcaml-vpi
hardcaml-waveterm	github.com/ujamjar/hardcaml-waveterm
hardcaml_waveterm	github.com/janestreet/hardcaml_waveterm
hardcaml-yosys	github.com/ujamjar/hardcaml-yosys
hashcons	github.com/backtracking/ocaml-hashcons
hashids	github.com/jacquev6/hashids-ocaml
hashset	github.com/UnixJunkie/hashset
haxe	github.com/HaxeFoundation/haxe
headache	github.com/Frama-C/headache
herelib	github.com/janestreet/herelib
hevea	github.com/maranget/hevea
hex	github.com/mirage/ocaml-hex
hidapi	github.com/vbmithr/ocaml-hidapi
higher	github.com/ocamllabs/higher
higher_kinded	github.com/janestreet/higher_kinded
higlo	github.com/zoggy/higlo
hiredis	github.com/zshipko/ocaml-hiredis
hkdf	github.com/hannesm/ocaml-hkdf
hlarp	github.com/hammerlab/hlarp
horned_worm	github.com/kkazuo/horned_worm
hts_shrink	github.com/UnixJunkie/hts_shrink
http2https	github.com/avsm/http2https
httpaf	github.com/inhabitedtype/httpaf
httpaf_caged	github.com/thedufer/httpaf_caged
http-cookie	github.com/lemaetech/http-cookie
http-multipart-formdata	github.com/lemaetech/http-mutlipart-formdata
huffman	github.com/jdrprod/huffman
humane-re	github.com/rgrinberg/humane-re
hvsock	github.com/mirage/ocaml-hvsock
hxd	github.com/dinosaure/hxd
i3ipc	github.com/Armael/ocaml-i3ipc
ibx	bitbucket.org/ogu/ibx
icalendar	github.com/roburio/icalendar
idd	github.com/netkat-lang/idd
idds	github.com/netkat-lang/idds
igvxml	github.com/hammerlab/igvxml
imagelib	github.com/rlepigre/ocaml-imagelib
imap	www.github.com/nojb/ocaml-imap
incr_dom	github.com/janestreet/incr_dom
incr_dom_interactive	github.com/janestreet/incr_dom_interactive
incr_dom_keyboard	github.com/janestreet/incr_dom_keyboard
incr_dom_partial_render	github.com/janestreet/incr_dom_partial_render
incr_dom_sexp_form	github.com/janestreet/incr_dom_sexp_form
incr_dom_widgets	github.com/janestreet/incr_dom_widgets
incremental	github.com/janestreet/incremental
incremental_kernel	github.com/janestreet/incremental_kernel
incr_map	github.com/janestreet/incr_map
incr_select	github.com/janestreet/incr_select
index	github.com/mirage/index
inferno	gitlab.inria.fr/fpottier/inferno
integers	github.com/ocamllabs/ocaml-integers
integers_stubs_js	github.com/o1-labs/integers_stubs_js
integration1d	github.com/Chris00/integration1d
interval	github.com/Chris00/ocaml-interval
interval-map	github.com/dgllghr/interval-map
inuit	github.com/let-def/inuit
io	github.com/rizo/flow
iocaml	github.com/andrewray/iocamlserver
iocamljs-kernel	github.com/andrewray/iocamljs
iocaml-kernel	github.com/andrewray/iocaml
io-page	github.com/mirage/io-page
ipaddr	github.com/mirage/ocaml-ipaddr
ipv6-multicast	github.com/vbmithr/ocaml-ipv6-multicast
iri	github.com/zoggy/ocaml-iri
irmin	github.com/mirage/irmin
irmin-indexeddb	github.com/talex5/irmin-indexeddb
irmin-watcher	github.com/mirage/irmin-watcher
irrlicht	github.com/fccm/OCaml-Irrlicht
iso639	github.com/paurkedal/ocaml-iso639
ISO8601	github.com/ocaml-community/ISO8601.ml
iter	github.com/c-cube/iter
jane-street-headers	github.com/janestreet/jane-street-headers
jane-street-tests	github.com/janestreet/jane-street-tests
javalib	github.com/javalib-team/javalib
javascriptcore	github.com/fxfactorial/ocaml-javascriptcore
jekyll-format	github.com/avsm/jekyll-format
jenga	github.com/janestreet/jenga
jerboa	github.com/StrykerKKD/Jerboa
jhupllib	github.com/JHU-PL-Lab/jhu-pl-lib
jingoo	github.com/tategakibunko/jingoo
jitsu	github.com/mirage/jitsu
jose	github.com/ulrikstrid/reason-jose
js-build-tools	github.com/janestreet/js-build-tools
JsOfOCairo	github.com/jacquev6/JsOfOCairo
js_of_ocaml	github.com/ocsigen/js_of_ocaml
js_of_ocaml-webgpu	github.com/tari3x/webgpu
json-data-encoding	gitlab.com/nomadic-labs/json-data-encoding
json_decoder	github.com/dagoof/ocaml-json-decoder
json-derivers	github.com/rgrinberg/json-derivers
json_of_jsonm	www.github.com/stevebleazard/ocaml-json-of-jsonm
jsonoo	github.com/mnxn/jsonoo
jsonrpc	github.com/ocaml/ocaml-lsp
jsoo_router	github.com/xvw/jsoo_router
jsoo_storage	github.com/xvw/jsoo_storage
jst-config	github.com/janestreet/jst-config
junit	github.com/Khady/ocaml-junit
jupyter	github.com/akabe/ocaml-jupyter
jupyter-kernel	github.com/ocaml-jupyter/jupyter-kernel
jwt	github.com/besport/ocaml-jwt
jwto	github.com/sporto/jwto
kafka	github.com/didier-wenzek/ocaml-kafka
kappa-agents	github.com/Kappa-Dev/KappaTools
KaSim	github.com/Kappa-Dev/KaSim
ke	github.com/mirage/ke
ketrew	github.com/hammerlab/ketrew
key-parsers	github.com/cryptosense/key-parsers
kicadsch	github.com/jnavila/plotkicadsch
kind2	github.com/kind2-mc/kind2
kinetic-client	github.com/openvstorage/kinetic-ocaml-client
kqueue	github.com/anuragsoni/kqueue-ml
kubecaml	github.com/andrenth/kubecaml
kyotocabinet	github.com/didier-wenzek/ocaml-kyotocabinet
lablgl	github.com/garrigue/lablgl
lablgtk	github.com/garrigue/lablgtk
lablgtk-extras	github.com/zoggy/lablgtk-extras
lablgtkosx	github.com/pirbo/lablGtkOSXApplication
lablqt	github.com/Kakadu/lablqt
labltk	github.com/garrigue/labltk
labrys	github.com/kit-ty-kate/labrys
lacaml	github.com/mmottl/lacaml
ladspa	github.com/savonet/ocaml-ladspa
lambda	github.com/dakk/lambda
lambda-runtime	github.com/anmonteiro/aws-lambda-ocaml-runtime
lambdasoup	github.com/aantron/lambdasoup
lambda_streams	github.com/Risto-Stevcev/lambda-streams
lambdoc	github.com/darioteixeira/lambdoc
lame	github.com/savonet/ocaml-lame
landmarks	github.com/LexiFi/landmarks
lascar	github.com/jserot/lascar
lastfm	github.com/savonet/ocaml-lastfm
launchd	github.com/mirage/ocaml-launchd
lazy-trie	github.com/mirage/ocaml-lazy-trie
lbfgs	github.com/Chris00/L-BFGS-ocaml
lbvs_consent	github.com/UnixJunkie/consent
ldap	github.com/kit-ty-kate/ocamldap
learn-ocaml	github.com/ocaml-sf/learn-ocaml
ledgerwallet	github.com/vbmithr/ocaml-ledger-wallet
ledit	github.com/chetmurthy/ledit
lem	github.com/rems-project/lem
lemonade	github.com/michipili/lemonade
lemonade-sqlite	github.com/michipili/lemonade-sqlite
lens	github.com/pdonadeo/ocaml-lens
let-if	github.com/reynir/let-if
letsencrypt	github.com/mmaker/ocaml-letsencrypt
letters	github.com/oxidizing/letters
leveldb	github.com/mfp/ocaml-leveldb
levenshtein	gitlab.com/camlspotter/ocaml_levenshtein
libdash	/github.com/mgree/libdash
libssh	github.com/fxfactorial/ocaml-libssh
libsvm	github.com/pveber/libsvm-ocaml
libudev	github.com/Armael/ocaml-libudev
libzipperposition	github.com/sneeuwballen/zipperposition
lilac	github.com/shnewto/lilac
lilis	github.com/Drup/LILiS
linenoise	github.com/ocaml-community/ocaml-linenoise
line-up-words	github.com/janestreet/line-up-words
linkage	github.com/stedolan/linkage
links	github.com/links-lang/links
linksem	github.com/rems-project/linksem
linol	github.com/c-cube/linol
linwrap	github.com/UnixJunkie/linwrap
lipsum	github.com/lindig/lipsum
liquidsoap	github.com/savonet/liquidsoap
liquidsoap-daemon	github.com/savonet/liquidsoap-daemon
litiom	github.com/darioteixeira/litiom
llvmgraph	github.com/Drup/llvmgraph
lmdb	github.com/Drup/ocaml-lmdb
lo	github.com/savonet/ocaml-lo
loga	github.com/yutopp/loga
logger-p5	github.com/dboulytchev/logger
logical	github.com/StrykerKKD/Logical
logs	erratique.ch/repos/logs
logs-async	github.com/vbmithr/logs-async
logs-ppx	github.com/ulrikstrid/logs-ppx
logs-syslog	github.com/hannesm/logs-syslog
lp	github.com/ktahar/ocaml-lp
lpi	github.com/baxtersa/lambda-pi
lru	github.com/pqwy/lru
lru-cache	github.com/zoggy/ocaml-lru-cache
lua-ml	github.com/lindig/lua-ml
lua_parser	github.com/drjdn/ocaml_lua_parser
lutils	gricad-gitlab.univ-grenoble-alpes.fr/verimag/synchrone/lutils
luv	github.com/aantron/luv
lwd	github.com/let-def/lwd
lwt	github.com/ocsigen/lwt
lwt_camlp4	github.com/aantron/lwt_camlp4
lwt-canceler	gitlab.com/nomadic-labs/lwt-canceler
lwt-dllist	github.com/mirage/lwt-dllist
lwt-exit	gitlab.com/nomadic-labs/lwt-exit
lwt_glib	github.com/ocsigen/lwt_glib
lwt_log	github.com/ocsigen/lwt_log
lwt_named_threads	github.com/ahrefs/lwt_named_threads
lwt-parallel	github.com/ivg/parallel
lwt-pipe	github.com/c-cube/lwt-pipe
lwt-pipeline	gitlab.com/nomadic-labs/lwt_pipeline
lwt_ssl	github.com/ocsigen/lwt_ssl
lwt-watcher	gitlab.com/nomadic-labs/lwt-watcher
lwt-zmq	github.com/hcarty/lwt-zmq
lymp	github.com/dbousque/lymp
lz4_chans	github.com/UnixJunkie/lz4-chans
macaque	github.com/ocsigen/macaque
macaroons	www.github.com/nojb/ocaml-macaroons
mad	github.com/savonet/ocaml-mad
magic-mime	github.com/mirage/ocaml-magic-mime
maki	github.com/c-cube/maki
malfunction	github.com/stedolan/malfunction
mariadb	github.com/andrenth/ocaml-mariadb
markdown	github.com/gildor478/ocaml-markdown
markup	github.com/aantron/markup.ml
matplotlib	github.com/LaurentMazare/ocaml-matplotlib
mc2	github.com/c-cube/mc2
mccs	github.com/AltGr/ocaml-mccs
md2mld	github.com/mseri/md2mld
mdx	github.com/realworldocaml/mdx
mecab	github.com/akabe/ocaml-mecab
mechaml	github.com/yannham/mechaml
memcad	github.com/Antique-team/memcad
memprof-limits	gitlab.com/gadmm/memprof-limits
memtrace	github.com/janestreet/memtrace
memtrace_viewer	github.com/janestreet/memtrace_viewer
menhir	gitlab.inria.fr/fpottier/menhir
mergeable-vector	github.com/kayceesrk/mergeable-vector
merge-fmt	github.com/hhugo/merge-fmt
merge-queues	github.com/mirage/merge-queues
merge-ropes	github.com/mirage/merge-ropes
merlin-extend	github.com/let-def/merlin-extend
mesh	github.com/Chris00/mesh
metapp	github.com/thierry-martinez/metapp
metaquot	github.com/thierry-martinez/metaquot
metrics	github.com/mirage/metrics
mew	github.com/kandu/mew
mew_vi	github.com/kandu/mew_vi
milter	github.com/andrenth/ocaml-milter
mimic	github.com/dinosaure/mimic
mindstorm	github.com/Chris00/ocaml-mindstorm
minicaml	github.com/0x0f0f0f/minicaml
minicli	github.com/UnixJunkie/minicli
minima-theme	github.com/avsm/ocaml-minima-theme
minios-xen	github.com/talex5/mini-os
minisat	github.com/c-cube/ocaml-minisat
minivpt	github.com/UnixJunkie/vp-tree
mirage	github.com/mirage/mirage
mirage-block	github.com/mirage/mirage-block
mirage-block-ccm	github.com/sg2342/mirage-block-ccm
mirage-block-ramdisk	github.com/mirage/mirage-block-ramdisk
mirage-block-solo5	github.com/mirage/mirage-block-solo5
mirage-block-unix	github.com/mirage/mirage-block-unix
mirage-block-xen	github.com/mirage/mirage-block-xen
mirage-bootvar-solo5	github.com/mirage/mirage-bootvar-solo5
mirage-bootvar-unix	github.com/mirage/mirage-bootvar-unix
mirage-bootvar-xen	github.com/mirage/mirage-bootvar-xen
mirage-btrees	github.com/ruhatch/mirage-btrees
mirage-clock	github.com/mirage/mirage-clock
mirage-console	github.com/mirage/mirage-console
mirage-console-solo5	github.com/mirage/mirage-console-solo5
mirage-crypto	github.com/mirage/mirage-crypto
mirage-device	github.com/mirage/mirage-device
mirage-entropy	github.com/mirage/mirage-entropy
mirage-flow	github.com/mirage/mirage-flow
mirage-flow-rawlink	github.com/mirage/mirage-flow-rawlink
mirage-fs	github.com/mirage/mirage-fs
mirage-fs-mem	github.com/roburio/mirage-fs-mem
mirage-fs-unix	github.com/mirage/mirage-fs-unix
mirage-kv	github.com/mirage/mirage-kv
mirage-kv-mem	github.com/mirage/mirage-kv-mem
mirage-kv-unix	github.com/mirage/mirage-kv-unix
mirage-logs	github.com/mirage/mirage-logs
mirage-nat	github.com/mirage/mirage-nat
mirage-net	github.com/mirage/mirage-net
mirage-net-fd	github.com/mirage/mirage-net-fd
mirage-net-flow	github.com/mirage/mirage-net-flow
mirage-net-macosx	github.com/mirage/mirage-net-macosx
mirage-net-solo5	github.com/mirage/mirage-net-solo5
mirage-net-unix	github.com/mirage/mirage-net-unix
mirage-net-xen	github.com/mirage/mirage-net-xen
mirage-os-shim	github.com/mirage/mirage-os-shim
mirage-profile	github.com/mirage/mirage-profile
mirage-protocols	github.com/mirage/mirage-protocols
mirage-qubes	github.com/mirage/mirage-qubes
mirage-random	github.com/mirage/mirage-random
mirage-random-stdlib	github.com/mirage/mirage-random-stdlib
mirage-random-test	github.com/mirage/mirage-random-test
mirage-seal	github.com/mirage/mirage-seal
mirage-stack	github.com/mirage/mirage-stack
mirage-tc	github.com/mirage/mirage-tc
mirage-time	github.com/mirage/mirage-time
mirage-unix	github.com/mirage/mirage-unix
mirage-vnetif	github.com/mirage/mirage-vnetif
mirage-xen	github.com/mirage/mirage-xen
mirage-xen-minios	github.com/mirage/mirage-xen-minios
mirage-xen-ocaml	github.com/mirage/mirage-platform
mirror	github.com/avsm/opam-mirror
misuja	gitlab.com/smondet/misuja
mixture	github.com/michipili/mixture
ml2mxml	github.com/yetanotherion/ml2mxml
mlbdd	github.com/arlencox/mlbdd
mld	github.com/disteph/mld
mldonkey	github.com/ygrek/mldonkey
mlfenv	github.com/thvnx/mlfenv
mlgmpidl	github.com/nberth/mlgmpidl
mlmpfr	github.com/thvnx/mlmpfr
lpost	github.com/backtracking/mlpost
mlt_parser	github.com/janestreet/mlt_parser
mm	github.com/savonet/ocaml-mm
mmap	github.com/mirage/mmap
mmdb	github.com/issuu/ocaml-mmdb
mock	github.com/cryptosense/ocaml-mock
modelica_ml	github.com/choeger/modelica.ml
modular-arithmetic	github.com/sonologico/modular-arithmetic
molenc	github.com/UnixJunkie/molenc
monadlib	github.com/Chattered/ocaml-monad
monolith	gitlab.inria.fr/fpottier/monolith
monomorphic	github.com/kit-ty-kate/ocaml-monomorphic
moss	github.com/Chris00/ocaml-moss
mparser	github.com/murmour/mparser
mpp	github.com/ocaml/MPP-language-blender
mrmime	github.com/mirage/mrmime
mrt-format	github.com/mor1/mrt-format
msat	github.com/Gbury/mSAT
msgpack	github.com/msgpack/msgpack-ocaml
msgpck	github.com/vbmithr/ocaml-msgpck
mssql	github.com/arenadotio/ocaml-mssql
mstruct	github.com/mirage/ocaml-mstruct
mtime	erratique.ch/repos/mtime
multipart_form	github.com/dinosaure/multipart_form
multipart-form-data	github.com/cryptosense/multipart-form-data
mustache	github.com/rgrinberg/ocaml-mustache
mutf8	github.com/wiml/ocaml-mutf8
mwt	github.com/hcarty/mwt
mysql_protocol	github.com/slegrand45/mysql_protocol
naboris	github.com/shawn-mcginty/naboris
nacc	github.com/codeanonorg/nacc
named-pipe	github.com/mirage/ocaml-named-pipe
namespaces	github.com/aantron/namespaces
nbd	github.com/xapi-project/nbd
netkat	github.com/netkat-lang/netkat
netlink	github.com/xapi-project/ocaml-netlink
netml	github.com/xguerin/netml
netsnmp	github.com/janestreet/netsnmp
nice_parser	github.com/smolkaj/ocaml-parsing
nlp	github.com/dave-tucker/ocaml-nlp
nmea	github.com/dakk/nmea
noCanren	github.com/Lozov-Petr/noCanren
nocoiner	github.com/marcoonroad/nocoiner
nocrypto	github.com/mirleft/ocaml-nocrypto
noise	github.com/emillon/ocaml-noise
nosetup	github.com/Leonidas-from-XIV/nosetup
note	erratique.ch/repos/note
not-ocamlfind	github.com/chetmurthy/not-ocamlfind
notty	github.com/pqwy/notty
notty_async	github.com/janestreet/notty_async
np	github.com/lehy/ocaml-sklearn
nproc	github.com/rizo/nproc
npy	github.com/LaurentMazare/npy-ocaml
nsq	github.com/ryanslade/nsq-ocaml
num	github.com/ocaml/num
numalib	www.github.com/stevebleazard/ocaml-numa
nunchaku	github.com/nunchaku-inria/nunchaku
nuscr	github.com/nuscr/nuscr
oasis2opam	github.com/ocaml/oasis2opam
obandit	github.com/freuk/obandit
obeam	github.com/yutopp/obeam
obelisk	github.com/Lelio-Brun/obelisk
obi	github.com/ocaml/obi
objsize	github.com/ygrek/objsize
obuild	github.com/ocaml-obuild/obuild
obuilder	github.com/ocurrent/obuilder
obus	github.com/ocaml-community/obus
oc45	github.com/tobast/OC4.5
ocal	github.com/mor1/ocal
ocaml	github.com/ocaml/ocaml
ocamlapi	github.com/nosman/Ocamlapi
ocaml_at_p	github.com/tsubame-sp/ocaml_at_p
ocaml-basics	github.com/advanced-schema/ocaml-basics
ocamlbuild-atdgen	github.com/rgrinberg/ocamlbuild-atdgen
ocamlbuild-pkg	github.com/kit-ty-kate/ocamlbuild-pkg
ocamlbuild-protoc	github.com/Khady/ocamlbuild-protoc
ocamlcodoc	gitlab.inria.fr/tmartine/ocamlcodoc
ocaml-compiler-libs	github.com/janestreet/ocaml-compiler-libs
ocamldot	github.com/zoggy/ocamldot
ocaml-expat	github.com/whitequark/ocaml-expat
ocamlfind	github.com/ocaml/ocamlfind
ocamlformat	github.com/ocaml-ppx/ocamlformat
ocamlformat_support	github.com/ocaml-ppx/ocamlformat
ocaml-freestanding	github.com/mirage/ocaml-freestanding
ocaml-gist	github.com/SanderSpies/ocaml-gist
ocamlgraph	github.com/backtracking/ocamlgraph
ocaml-http	github.com/sacerdot/ocaml-http
ocaml-js-stdlib	github.com/dannywillems/ocaml-js-stdlib
ocamllint	github.com/cryptosense/ocamllint
ocaml-lua	github.com/pdonadeo/ocaml-lua
ocaml-makefile	github.com/mmottl/ocaml-makefile
ocaml-migrate-parsetree	github.com/ocaml-ppx/ocaml-migrate-parsetree
ocaml-migrate-parsetree-ocamlbuild	github.com/let-def/ocaml-migrate-parsetree
ocaml-monadic	github.com/zepalmer/ocaml-monadic
ocamlnet	gitlab.com/gerdstolpmann/lib-ocamlnet3
ocaml_plugin	github.com/janestreet/ocaml_plugin
ocaml-print-intf	github.com/avsm/ocaml-print-intf
ocaml-protoc	github.com/mransan/ocaml-protoc
ocaml-protoc-plugin	github.com/issuu/ocaml-protoc-plugin
ocaml-protoc-yojson	github.com/mransan/ocaml-protoc-yojson
ocaml-r	github.com/pveber/ocaml-r
ocamlsdl2	github.com/fccm/OCamlSDL2
ocamlsdl2-image	github.com/fccm/OCamlSDL2_Image
ocamlsdl2-ttf	github.com/fccm/OCamlSDL2_TTF
ocamlspot	gitlab.com/camlspotter/ocamlspot
ocaml-syntax-shims	github.com/ocaml-ppx/ocaml-syntax-shims
ocaml-systemd	github.com/juergenhoetzel/ocaml-systemd
ocaml-top	github.com/OCamlPro/ocaml-top
ocaml-topexpect	github.com/let-def/topexpect
ocaml-variants	github.com/ocaml/ocaml
ocaml-vdom	github.com/LexiFi/ocaml-vdom
ocaml-version	github.com/ocurrent/ocaml-version
ocaml-xdg-basedir	github.com/gildor478/ocaml-xdg-basedir
OCanren	github.com/JetBrains-Research/OCanren
ocb	github.com/OCamlPro/ocb
ocb-stubblr	github.com/pqwy/ocb-stubblr
ocephes	github.com/rleonid/ocephes
ocf	github.com/zoggy/ocf
oci	github.com/bobot/oci
ocolor	github.com/marc-chevalier/ocolor
ocp-browser	github.com/OCamlPro/ocp-index
ocp-build	github.com/OCamlPro/typerex-build
ocp-indent	github.com/OCamlPro/ocp-indent
ocp-indent-nlfork	github.com/OCamlPro/ocp-indent
ocp-index-top	github.com/reynir/ocp-index-top
ocplib-concur	github.com/OCamlPro/ocplib-concur
ocplib-endian	github.com/OCamlPro/ocplib-endian
ocplib-json-typed	github.com/ocamlpro/ocplib-json-typed
ocplib-resto	github.com/OCamlPro/ocplib-resto
ocplib-simplex	github.com/OCamlPro-Iguernlala/ocplib-simplex
ocplib_stuff	github.com/ocamlpro/ocplib_stuff
ocp-pp	github.com/OCamlPro/ocp-build
ocsigen-i18n	github.com/besport/ocsigen-i18n
ocsigenserver	github.com/ocsigen/ocsigenserver
ocsigen-start	github.com/ocsigen/ocsigen-start
ocsigen-toolkit	github.com/ocsigen/ocsigen-toolkit
coctavius	github.com/ocaml-doc/octavius
ocveralls	github.com/sagotch/ocveralls
odash	github.com/roryqueue/odash
odate	github.com/hhugo/odate
odds	github.com/raphael-proust/odds
odepack	github.com/Chris00/ocaml-odepack
odig	erratique.ch/repos/odig
odnnr	github.com/UnixJunkie/odnnr
odoc	github.com/ocaml/odoc
offheap	github.com/nandor/offheap
ofx	github.com/mvalle/ocaml-ofx
ogen	github.com/nv-vn/ogen
ogg	github.com/savonet/ocaml-ogg
oidc	github.com/ulrikstrid/ocaml-oidc
ojquery	github.com/ocsigen/ojquery
ojs-base	github.com/zoggy/ojs-base
olinq	github.com/c-cube/olinq
ollvm-tapir	github.com/nholland94/ollvm-tapir
olmi	github.com/xvw/olmi
oloop	github.com/ocaml/oloop
omake	github.com/ocaml-omake/omake
omd	github.com/ocaml/omd
omigrate	github.com/tmattio/omigrate
oml	github.com/hammerlab/oml
omlr	github.com/UnixJunkie/omlr
omonad	github.com/yallop/omonad
opaca	github.com/spreadLink/opaca
opal	github.com/pyrocat101/opal
opam-0install	github.com/ocaml-opam/opam-0install-solver
opam2web	github.com/ocaml/opam2web
opam-bin	github.com/ocamlpro/opam-bin
opam-bundle	github.com/AltGr/opam-bundle
opam-client	github.com/ocaml/opam
opam-compiler	github.com/ocaml-opam/opam-compiler
opamconfig	github.com/michipili/opamconfig
opam-depext	github.com/ocaml/opam-depext
opam-dune-lint	github.com/ocurrent/opam-dune-lint
opam-ed	github.com/AltGr/opam-ed
opam-file-format	github.com/ocaml/opam-file-format
opamfu	github.com/ocamllabs/opamfu
opam-lock	github.com/AltGr/opam-lock
opam-monorepo	github.com/ocamllabs/opam-monorepo
opam_of_packagejson	github.com/bsansouci/opam_of_packagejson
opam-package-upgrade	github.com/AltGr/opam-package-upgrade
opam-publish	github.com/ocaml/opam-publish
opam-sync-github-prs	github.com/avsm/opam-sync-github-prs
opasswd	github.com/xapi-project/ocaml-opasswd
open	github.com/smolkaj/ocaml-open
openQASM	github.com/inQWIRE/openqasm-parser
opium-graphql	github.com/rgrinberg/opium
oplot	github.com/sanette/oplot
oplsr	github.com/UnixJunkie/oplsr
opomodoro	github.com/m-laniakea/opomodoro
optal	github.com/ocamlpro/optal
opti	github.com/magnusjonsson/opti
optimization1d	github.com/Chris00/optimization1d
optint	github.com/mirage/optint
opus	github.com/savonet/ocaml-opus
oraft	github.com/komamitsu/oraft
orandforest	github.com/tobast/ORandForest
oranger	github.com/UnixJunkie/oranger
order-i3-xfce	github.com/EmileTrotignon/order-i3-xfce
orec	github.com/Octachron/orec
orewa	github.com/Leonidas-from-XIV/orewa
orm	github.com/mirage/orm
orocksdb	github.com/domsj/orocksdb
orpie	github.com/pelzlpj/orpie
orrandomForest	github.com/UnixJunkie/orrandomForest
orsetto	bitbucket.org/jhw/orsetto
orsvm_e1071	github.com/UnixJunkie/orsvm-e1071
orun	github.com/shakthimaan/orun
orxgboost	github.com/UnixJunkie/orxgboost
osbx	github.com/darrenldl/ocaml-SeqBox
oseq	github.com/c-cube/oseq
oskel	github.com/CraigFe/oskel
ostap	github.com/Kakadu/ostap
osx-acl	github.com/dsheets/ocaml-osx-acl
osx-attr	github.com/dsheets/ocaml-osx-attr
osx-cf	github.com/dsheets/ocaml-osx-cf
osx-fsevents	github.com/dsheets/ocaml-osx-fsevents
osx-membership	github.com/dsheets/ocaml-osx-membership
osx-mount	github.com/dsheets/ocaml-osx-mount
osx-plutil	github.com/dsheets/ocaml-osx-plutil
osx-secure-transport	github.com/toots/ocaml-osx-secure-transport
osx-xattr	github.com/dsheets/ocaml-osx-xattr
otetris	github.com/vzaliva/otetris
otf	gitlab.com/pictyeye/otf
otfm	erratique.ch/repos/otfm
otr	github.com/hannesm/ocaml-otr
ott	github.com/ott-lang/ott
otto	github.com/jrraymond/otto
ounit	github.com/gildor478/ounit
owebl	github.com/eatonphil/owebl
owee	github.com/let-def/owee
owl	github.com/owlbarn/owl
owl-jupyter	github.com/owlbarn/owl_jupyter
owl-ode	github.com/owlbarn/owl_ode
owl-opt	github.com/owlbarn/owl_opt
owl-symbolic	github.com/owlbarn/owl_symbolic
owork	github.com/jeffa5/owork
oxylc	gitlab.com/selfReferentialName/oxylc
p4pp	github.com/cornell-netlab/p4pp/
pa_bench	github.com/janestreet/pa_bench
pa_bin_prot	github.com/janestreet/pa_bin_prot
pacomb	github.com/craff/pacomb
paf	github.com/dinosaure/paf-le-chien
pa_fields_conv	github.com/janestreet/pa_fields_conv
pam	github.com/janestreet/pam
pandoc	github.com/smimram/ocaml-pandoc
pa_ounit	github.com/janestreet/pa_ounit
papi	github.com/pqwy/ocaml-papi
pa_ppx	github.com/camlp5/pa_ppx
pa_ppx_ag	github.com/camlp5/pa_ppx_ag
pa_ppx_hashcons	github.com/camlp5/pa_ppx_hashcons
pa_ppx_migrate	github.com/camlp5/pa_ppx_migrate
pa_ppx_q_ast	github.com/camlp5/pa_ppx_q_ast
pa_ppx_unique	github.com/camlp5/pa_ppx_unique
parany	github.com/UnixJunkie/parany
pardi	github.com/UnixJunkie/pardi
pareto	github.com/superbobry/pareto
parmap	github.com/rdicosmo/parmap
parse-argv	github.com/mirage/parse-argv
parsexp	github.com/janestreet/parsexp
parsexp_io	github.com/janestreet/parsexp_io
parsley	github.com/ghilesZ/parsley
partition_map	github.com/rleonid/partition_map
pa_sexp_conv	github.com/janestreet/pa_sexp_conv
pa_sqlexpr	github.com/mfp/ocaml-sqlexpr
passmaker	github.com/darioteixeira/passmaker
pa_structural_sexp	github.com/janestreet/pa_structural_sexp
patch	github.com/hannesm/patch
patdiff	github.com/janestreet/patdiff
pa_test	github.com/janestreet/pa_test
path_glob	gitlab.com/gasche/path_glob
patience_diff	github.com/janestreet/patience_diff
pattern	github.com/thierry-martinez/pattern
pa_typerep_conv	github.com/janestreet/pa_typerep_conv
pa_variants_conv	github.com/janestreet/pa_variants_conv
pb	github.com/yallop/ocaml-pb
pbkdf	github.com/abeaumont/ocaml-pbkdf
pcap-format	github.com/mirage/ocaml-pcap
pci	github.com/simonjbeaumont/ocaml-pci
pds-reachability	github.com/JHU-PL-Lab/pds-reachability
pecu	github.com/mirage/pecu
petr4	github.com/cornell-netlab/petr4/
pfff	github.com/returntocorp/pfff
pf-qubes	github.com/roburio/ocaml-pf
pgocaml	github.com/darioteixeira/pgocaml
pg_query	github.com/roddyyaga/pg_query-ocaml
pgx	github.com/arenadotio/pgx
phantom-algebra	github.com/Octachron/phantom_algebra
phashtbl	github.com/UnixJunkie/phashtbl
phonetic	github.com/geneweb/phonetic
phox	github.com/craff/phox
piaf	github.com/anmonteiro/piaf
picasso	github.com/ghilesZ/picasso
pilat	github.com/Stevendeo/Pilat
pipebang	github.com/janestreet/pipebang
pixel_pusher	github.com/mbacarella/pixel_pusher
pkcs11	github.com/cryptosense/pkcs11
pla	github.com/modlfo/pla
plist	github.com/fxfactorial/ocaml-plist
plist-xml	github.com/alan-j-hu/ocaml-plist-xml
plplot	github.com/hcarty/ocaml-plplot
polyglot	github.com/dsheets/polyglot
polynomial	gitlab.com/dannywillems/ocaml-polynomial
pomap	github.com/mmottl/pomap
portaudio	github.com/savonet/ocaml-portaudio
portaudio_c_bindings	github.com/wlitwin/portaudio_c_bindings
portia	github.com/rixed/portia
posixat	github.com/janestreet/posixat
posix-base	github.com/savonet/ocaml-posix
postgres_async	github.com/janestreet/postgres_async
pp	github.com/ocaml-dune/pp
ppx_accessor	github.com/janestreet/ppx_accessor
ppx_assert	github.com/janestreet/ppx_assert
ppx_ast	github.com/janestreet/ppx_ast
ppx_bap	github.com/BinaryAnalysisPlatform/ppx_bap
ppx_base	github.com/janestreet/ppx_base
ppx_bench	github.com/janestreet/ppx_bench
ppx_bigarray	github.com/akabe/ppx_bigarray
ppx_bin_prot	github.com/janestreet/ppx_bin_prot
ppx_blob	github.com/johnwhitington/ppx_blob
ppx_bsx	github.com/cxa/ppx_bsx
ppx_cold	github.com/janestreet/ppx_cold
ppx_compare	github.com/janestreet/ppx_compare
ppx_compose	github.com/paurkedal/ppx_compose
ppx_const	github.com/mcclure/ppx_const
ppx_conv_func	github.com/janestreet/ppx_conv_func
ppx_core	github.com/janestreet/ppx_core
ppx_cstubs	github.com/fdopen/ppx_cstubs
ppx_csv_conv	github.com/janestreet/ppx_csv_conv
ppx_custom_printf	github.com/janestreet/ppx_custom_printf
ppx_debugger	github.com/xvw/ppx_debugger
ppx_defer	github.com/hcarty/ppx_defer
ppx_deriving	github.com/ocaml-ppx/ppx_deriving
ppx_deriving_argparse	github.com/masashi-y/ppx_deriving_argparse
ppx_deriving_cmdliner	github.com/hammerlab/ppx_deriving_cmdliner
ppx_deriving_crowbar	github.com/yomimono/ppx_deriving_crowbar
ppx_deriving_hardcaml	github.com/janestreet/ppx_deriving_hardcaml
ppx_deriving_protobuf	github.com/ocaml-ppx/ppx_deriving_protobuf
ppx_deriving_protocol	github.com/andersfugmann/ppx_protocol_conv
ppx_deriving_yaml	github.com/patricoferris/ppx_deriving_yaml
ppx_deriving_yojson	github.com/ocaml-ppx/ppx_deriving_yojson
ppx_distr_guards	github.com/vogler/ppx_distr_guards
ppx_driver	github.com/janestreet/ppx_driver
ppx_enum	github.com/cryptosense/ppx_enum
ppx_enumerate	github.com/janestreet/ppx_enumerate
ppx_expect	github.com/janestreet/ppx_expect
ppx_factory	github.com/cryptosense/ppx_factory
ppx_fail	github.com/janestreet/ppx_fail
ppx_fields_conv	github.com/janestreet/ppx_fields_conv
ppxfind	github.com/jeremiedimino/ppxfind
ppx_fixed_literal	github.com/janestreet/ppx_fixed_literal
ppx_fun	github.com/little-arhat/ppx_fun
ppx_gen_rec	github.com/flowtype/ocaml-ppx_gen_rec
ppx_getenv	github.com/ocaml-ppx/ppx_getenv
ppx_graphql	github.com/andreas/ppx_graphql
ppx_hardcaml	github.com/xguerin/ppx_hardcaml
ppx_hash	github.com/janestreet/ppx_hash
ppx_here	github.com/janestreet/ppx_here
ppx_import	github.com/ocaml-ppx/ppx_import
ppx_inline_test	github.com/janestreet/ppx_inline_test
ppx_jane	github.com/janestreet/ppx_jane
ppx_json_types	github.com/nv-vn/otp
ppx_js_style	github.com/janestreet/ppx_js_style
ppx_let	github.com/janestreet/ppx_let
ppxlib	github.com/ocaml-ppx/ppxlib
ppx_log	github.com/janestreet/ppx_log
ppx_measure	github.com/xvw/ppx_measure
ppx_meta_conv	gitlab.com/camlspotter/ppx_meta_conv
ppx_metaquot	github.com/janestreet/ppx_metaquot
ppx_module_timer	github.com/janestreet/ppx_module_timer
ppx_monoid	github.com/bobatkey/ppx-monoid
ppx_mysql	github.com/issuu/ppx_mysql
ppx_nanocaml	github.com/nanocaml/nanocaml
ppx_netblob	github.com/chrismamo1/ppx_netblob
ppx_optcomp	github.com/janestreet/ppx_optcomp
ppx_optional	github.com/janestreet/ppx_optional
ppx_pattern_bind	github.com/janestreet/ppx_pattern_bind
ppx_pipebang	github.com/janestreet/ppx_pipebang
ppx_python	github.com/janestreet/ppx_python
ppx_rapper	github.com/roddyyaga/ppx_rapper
ppx_regexp	github.com/paurkedal/ppx_regexp
ppx_repr	github.com/mirage/repr
ppx_sexp_conv	github.com/janestreet/ppx_sexp_conv
ppx_sexp_message	github.com/janestreet/ppx_sexp_message
ppx_sexp_value	github.com/janestreet/ppx_sexp_value
ppx_show	github.com/thierry-martinez/ppx_show
ppx_stable	github.com/janestreet/ppx_stable
ppx_string	github.com/janestreet/ppx_string
ppx_string_interpolation	github.com/bloomberg/ppx_string_interpolation
ppx_test	gitlab.com/camlspotter/ppx_test
ppx_there	github.com/NathanReb/ppx_there
ppx_tools	github.com/ocaml-ppx/ppx_tools
ppx_traverse	github.com/janestreet/ppx_traverse
ppx_traverse_builtins	github.com/janestreet/ppx_traverse_builtins
ppx_type_conv	github.com/janestreet/ppx_type_conv
ppx_typerep_conv	github.com/janestreet/ppx_typerep_conv
ppx_variants_conv	github.com/janestreet/ppx_variants_conv
ppx_view	github.com/ocaml-ppx/ppx_view
ppx_where	github.com/nv-vn/ppx_where
ppxx	gitlab.com/camlspotter/ppxx
ppx_xml_conv	github.com/janestreet/ppx_xml_conv
ppx_yojson	github.com/NathanReb/ppx_yojson
ppx_yojson_conv	github.com/janestreet/ppx_yojson_conv
ppx_yojson_conv_lib	github.com/janestreet/ppx_yojson_conv_lib
pratter	github.com/gabrielhdt/pratter
prbnmcn-clustering	github.com/igarnier/prbnmcn-clustering
prbnmcn-mcts	github.com/igarnier/prbnmcn-mcts
prbnmcn-ucb1	gitlab.com/igarnier/monorepo
prettiest	github.com/andreasfrom/prettiest
prettym	github.com/dinosaure/prettym
primes	github.com/KitFreddura/OCaml-Primes
printbox	github.com/c-cube/printbox
process	github.com/dsheets/ocaml-process
progress	github.com/CraigFe/progress
prom	github.com/vbmithr/ocaml-prometheus
prometheus	github.com/mirage/prometheus
promise	github.com/aantron/promise
promise_jsoo	github.com/mnxn/promise_jsoo
protocell	github.com/martinslota/protocell
protocol-9p	github.com/mirage/ocaml-9p
protocol_version_header	github.com/janestreet/protocol_version_header
psq	github.com/pqwy/psq
psyche	github.com/0918nobita/psyche
ptmap	github.com/backtracking/ptmap
ptset	github.com/backtracking/ptset
publish	github.com/ocaml/opam-publish
pulseaudio	github.com/savonet/ocaml-pulseaudio
pumping	github.com/Drup/pumping
pure-splitmix	github.com/Lysxia/pure-splitmix
pxp	gitlab.camlcity.org/gerd/lib-pxp
py	github.com/zshipko/ocaml-py
pyml	github.com/thierry-martinez/pyml
pythonlib	github.com/janestreet/pythonlib
qbf	github.com/c-cube/ocaml-qbf
qcheck	github.com/c-cube/qcheck
qcow	github.com/mirage/ocaml-qcow
qcstm	github.com/jmid/qcstm
qinap	github.com/guillecosta/qinap
qiskit	github.com/dakk/caml_qiskit
qrc	erratique.ch/repos/qrc
qrencode	github.com/vbmithr/qrencode-ocaml
quest	github.com/lindig/quest
quests	github.com/roddyyaga/quests
radare2	github.com/fxfactorial/ocaml-radare2
radis	github.com/dinosaure/radis
randomconv	github.com/hannesm/randomconv
range	github.com/aldrikfr/range
ranger	github.com/rgrinberg/ranger
rankers	github.com/UnixJunkie/rankers
rashell	github.com/michipili/rashell
rawlink	github.com/haesbaert/rawlink
raygun4ocaml	github.com/lidcore/raygun4ocaml
raylib	github.com/tjammer/raylib-ocaml
rdbg	gricad-gitlab.univ-grenoble-alpes.fr/verimag/synchrone/rdbg
re	github.com/ocaml/ocaml-re
re2	github.com/janestreet/re2
re2_stable	github.com/janestreet/re2_stable
reactiveData	github.com/ocsigen/reactiveData
reanalyze	github.com/rescript-association/reanalyze
reason-standard	github.com/dean177/reason-standard
receive-mail	github.com/CREATe-centre/receive-mail
record_builder	github.com/janestreet/record_builder
records	github.com/cryptosense/records
reddit_api_async	github.com/leviroth/ocaml-reddit-api
redirect	github.com/thierry-martinez/redirect
redis	github.com/0xffea/ocaml-redis
reedsolomon	github.com/ujamjar/reedsolomon
reed-solomon-erasure	gitlab.com/darrenldl/ocaml-reed-solomon-erasure
regenerate	github.com/regex-generate/regenerate
reparse	github.com/lemaetech/reparse
res	github.com/mmottl/res
resource_cache	github.com/janestreet/resource_cache
resource-pooling	github.com/ocsigen/resource-pooling
resp	github.com/zshipko/resp
result	github.com/janestreet/result
rfc6287	github.com/sg2342/ocaml-rfc6287
rfc7748	github.com/burgerdev/ocaml-rfc7748
rfsm	github.com/jserot/rfsm
rhythm	github.com/decent-algorithms/rhythm
riakc_ppx	github.com/struktured/riakc_ppx
ringo	gitlab.com/nomadic-labs/ringo
river	github.com/kayceesrk/river
rlp	github.com/pirapira/rlp-ocaml
rmlbuild	github.com/reactiveml/rmlbuild
roman	github.com/johnwhitington/roman
root1d	github.com/Chris00/root1d
rope	github.com/Chris00/ocaml-rope
rosetta	github.com/mirage/rosetta
rotor	gitlab.com/trustworthy-refactoring/refactorer
routes	github.com/anuragsoni/routes
rpc_parallel	github.com/janestreet/rpc_parallel
rubytt	github.com/chenyukang/rubytt
rungen	github.com/shakthimaan/rungen
rusage	github.com/CraigFe/ocaml-rusage
safepass	github.com/darioteixeira/ocaml-safepass
sail	github.com/rems-project/sail
salsa20	github.com/abeaumont/ocaml-salsa20
salsa20-core	github.com/abeaumont/ocaml-salsa20-core
samplerate	github.com/savonet/ocaml-samplerate
sanddb	github.com/StrykerKKD/SandDB
sanlock	github.com/simonjbeaumont/ocaml-sanlock
sattools	github.com/ujamjar/sattools
satyrographos	github.com/na4zagin3/satyrographos
scgi	github.com/bikallem/ocaml-scgi
schroedinger	github.com/savonet/ocaml-schroedinger
scrypt	github.com/constfun/ocaml-scrypt
scrypt-kdf	github.com/abeaumont/ocaml-scrypt-kdf
secp256k1	github.com/dakk/secp256k1-ml
secp256k1-internal	gitlab.com/nomadic-labs/ocaml-secp256k1-internal
sedlex	github.com/ocaml-community/sedlex
sek	gitlab.inria.fr/fpottier/sek
selective	github.com/snowleopard/selective-ocaml
semaphore-compat	github.com/mirage/semaphore-compat
semver	github.com/rgrinberg/ocaml-semver
semver2	github.com/dividat/ocaml-semver
sendmsg	github.com/pqwy/sendmsg
sentry	github.com/brendanlong/sentry-ocaml
sequencer_table	github.com/janestreet/sequencer_table
sequoia	github.com/andrenth/sequoia
serial	github.com/m-laniakea/oserial
session	github.com/inhabitedtype/ocaml-session
sessions	github.com/essdotteedot/sessions
setcore	github.com/UnixJunkie/setcore
setr	github.com/arlencox/SETr
sexp	github.com/janestreet/sexp
sexp_diff_kernel	github.com/janestreet/sexp_diff_kernel
sexplib	github.com/janestreet/sexplib
sexplib0	github.com/janestreet/sexplib0
sexp_macro	github.com/janestreet/sexp_macro
sexp_pretty	github.com/janestreet/sexp_pretty
sexp_select	github.com/janestreet/sexp_select
sfml	github.com/fccm/ocaml-sfml
sha	github.com/djs55/ocaml-sha
shapefile	github.com/cyril-allignol/ocaml-shapefile
shared-block-ring	github.com/mirage/shared-block-ring
shared-memory-ring	github.com/mirage/shared-memory-ring
shared-secret	github.com/marcoonroad/shared-secret
shcaml	github.com/tov/shcaml
shell	github.com/janestreet/shell
shexp	github.com/janestreet/shexp
shine	github.com/savonet/ocaml-shine
sibylfs	github.com/sibylfs/sibylfs_src
sid	gitlab.com/phgsng/ocaml-sid
sihl	github.com/oxidizing/sihl
sill	github.com/ISANobody/sill
simple63	github.com/barko/simple63
simple-diff	github.com/gjaldon/simple_diff
skkserv-lite	github.com/anyakichi/ocaml-skkserv-lite
slack-backup	github.com/Khady/slack-backup
slap	github.com/akabe/slap
smbc	github.com/c-cube/smbc
smtlib-utils	github.com/c-cube/smtlib-utils
Snowflake	gitlab.com/boreal-ldd/snowflake
socialpeek	github.com/erizocosmico/ocaml-socialpeek
sociaml-facebook-api	github.com/dominicjprice/sociaml-facebook-api
sociaml-oauth-client	github.com/CREATe-centre/sociaml-oauth-client
sociaml-tumblr-api	github.com/CREATe-centre/sociaml-tumblr-api
socket-daemon	github.com/zoggy/ocaml-socket-daemon
sodium	github.com/dsheets/ocaml-sodium
solo5-bindings-genode	github.com/solo5/solo5
solvuu-build	github.com/solvuu/solvuu-build
solvuu_build	github.com/solvuu/solvuu_build
sosa	github.com/hammerlab/sosa
soundtouch	github.com/savonet/ocaml-soundtouch
soupault	github.com/dmbaturin/soupault
space-search	github.com/konne88/SpaceSearch
sparrow	github.com/ropas/sparrow
spawn	github.com/janestreet/spawn
speex	github.com/savonet/ocaml-speex
spf	github.com/andrenth/ocaml-spf
sphinxcontrib-ocaml	github.com/jacquev6/sphinxcontrib-ocaml
spin	github.com/tmattio/spin
spirv	github.com/nholland94/spirv-ocaml
splay_tree	github.com/janestreet/splay_tree
splittable_random	github.com/janestreet/splittable_random
spoc	github.com/mathiasbourgoin/SPOC
spotlib	gitlab.com/camlspotter/spotlib
sqlgg	github.com/ygrek/sqlgg
sqlite3_utils	github.com/c-cube/sqlite3_utils
srs	github.com/andrenth/ocaml-srs
srt	github.com/savonet/ocaml-srt
ssh-agent	github.com/reynir/ocaml-ssh-agent
ssl	github.com/savonet/ocaml-ssl
sslconf	github.com/awuersch/sslconf
stationary	github.com/imeckler/stationary
statmemprof-emacs	github.com/jhjourdan/statmemprof-emacs
stb_image	github.com/let-def/stb_image
stb_image_write	github.com/def-lkb/stb_image_write
stb_truetype	github.com/let-def/stb_truetype
stdcompat	github.com/thierry-martinez/stdcompat
stdint	github.com/andrenth/ocaml-stdint
stdio	github.com/janestreet/stdio
stdlib-diff	github.com/jhrdina/ocaml-diff
stdlib-shims	github.com/ocaml/stdlib-shims
stitch	github.com/cryptosense/ocaml-stitch
streaming	github.com/odis-labs/streaming
string_dict	github.com/janestreet/string_dict
stringext	github.com/rgrinberg/stringext
sturgeon	github.com/let-def/sturgeon
subscriptions-transport-ws	github.com/anmonteiro/ocaml-subscriptions-transport-ws
subtype-refinement	github.com/marcoonroad/subtype-refinement
swagger	github.com/andrenth/ocaml-swagger
syndic	github.com/Cumulus/Syndic
syslog-message	github.com/verbosemode/syslog-message
syslog-rfc5424	github.com/vbmithr/ocaml-syslog-rfc5424
sys-socket	github.com/toots/ocaml-sys-socket
systemverilog	github.com/xguerin/ocaml-systemverilog
taglib	github.com/savonet/ocaml-taglib
taglog	github.com/zoggy/ocaml-taglog
tallgeese	github.com/fxfactorial/tallgeese
tar	github.com/mirage/ocaml-tar
tcpip	github.com/mirage/mirage-tcpip
tdk	github.com/frenetic-lang/ocaml-tdk
teash	github.com/neochrome/teash
telegraml	github.com/nv-vn/telegraml
telltime	github.com/daypack-dev/telltime
tensorboard	github.com/LaurentMazare/ocaml-tensorboard
tensorflow	github.com/LaurentMazare/tensorflow-ocaml
terminal_size	github.com/cryptosense/terminal_size
testrunner	github.com/zoggy/ocaml-testrunner
text	github.com/vbmithr/ocaml-text
textmate-language	github.com/alan-j-hu/ocaml-textmate-language
textrazor	github.com/Richard-Degenne/ocaml-textrazor
textutils	github.com/janestreet/textutils
textutils_kernel	github.com/janestreet/textutils_kernel
textwrap	github.com/superbobry/ocaml-textwrap
tezos	gitlab.com/tezos/tezos
tezos-rust-libs	gitlab.com/tezos/tezos-rust-libs
tftp	github.com/mor1/ocaml-tftp
theora	github.com/savonet/ocaml-theora
timed	github.com/rlepigre/ocaml-timed
time_now	github.com/janestreet/time_now
timere	github.com/daypack-dev/timere
timezone	github.com/janestreet/timezone
tiny_httpd	github.com/c-cube/tiny_httpd
tiny_json	gitlab.com/camlspotter/tiny_json
tip-parser	github.com/c-cube/tip-parser
tjr_simple_earley	github.com/tomjridge/tjr_simple_earley
tldr	github.com/RosalesJ/tldr-ocaml
tls	github.com/mirleft/ocaml-tls
tlstunnel	github.com/hannesm/tlstunnel
toml	github.com/ocaml-toml/To.ml
toml-cconv	github.com/mackwic/To.ml
topkg-care	erratique.ch/repos/topkg
topkg-jbuilder	github.com/samoht/topkg-jbuilder
toplevel_backend	github.com/janestreet/toplevel_backend
toplevel_expect_test	github.com/janestreet/toplevel_expect_test
topological_sort	github.com/janestreet/topological_sort
torch	github.com/LaurentMazare/ocaml-torch
touist	github.com/touist/touist
tplib	scm.gforge.inria.fr/anonscm/git/tplib/tplib
tqdm	github.com/LaurentMazare/ocaml-tqdm
traildb	github.com/didier-wenzek/ocaml-traildb
trakeva	github.com/smondet/trakeva
transept	github.com/d-plaindoux/transept
transmission-rpc	github.com/bataille/ocaml-transmission-rpc
traverse	github.com/thierry-martinez/traverse
travesty	github.com/MattWindsor91/travesty
travis-opam	github.com/ocaml/ocaml-ci-scripts
trax	github.com/mjambon/trax
tree_layout	github.com/Drup/tree_layout
treeprint	gitlab.com/camlspotter/treeprint
tsdl	erratique.ch/repos/tsdl
tsdl-image	github.com/tokenrove/tsdl-image
tsdl-mixer	github.com/tokenrove/tsdl-mixer
tsdl-ttf	github.com/tokenrove/tsdl-ttf
tsort	github.com/dmbaturin/ocaml-tsort
tuareg	github.com/ocaml/tuareg
tube	github.com/alinpopa/tube
tuntap	github.com/mirage/ocaml-tuntap
type-beat	github.com/oklm-wsh/TypeBeat
typebeat	github.com/mirage/typebeat
type_conv	github.com/janestreet/type_conv
typerep	github.com/janestreet/typerep
typerep_extended	github.com/janestreet/typerep_extended
typerex-attic	github.com/OCamlPro/typerex-attic
typerex-binutils	github.com/OCamlPro/typerex-binutils
typerex-clibs	github.com/OCamlPro/typerex-clibs
typerex-lldb	github.com/OCamlPro/typerex-lldb
typerex-system	github.com/OCamlPro/typerex-system
tyre	github.com/Drup/tyre
tyxml	github.com/ocsigen/tyxml
ubase	github.com/sanette/ubase
ubpf	github.com/ahrefs/ocaml-ubpf
uchar	github.com/ocaml/uchar
ucorelib	github.com/yoriyuki/ucorelib
uecc	gitlab.com/nomadic-labs/ocaml-uecc
uint	github.com/andrenth/ocaml-uint
ulex-camlp5	github.com/whitequark/ulex
ulid	github.com/stripedpajamas/ocaml-ulid
unidecode	github.com/geneweb/unidecode
unionFind	gitlab.inria.fr/fpottier/unionFind
unix-dirent	github.com/dsheets/ocaml-unix-dirent
unix-errno	github.com/dsheets/ocaml-unix-errno
unix-fcntl	github.com/dsheets/ocaml-unix-fcntl
unix-sys-resource	github.com/dsheets/ocaml-unix-sys-resource
unix-sys-stat	github.com/dsheets/ocaml-unix-sys-stat
unix-time	github.com/dsheets/ocaml-unix-time
unix-type-representations	github.com/yallop/ocaml-unix-type-representations
unix-unistd	github.com/dsheets/ocaml-unix-unistd
unmagic	gitlab.com/camlspotter/unmagic
unstrctrd	github.com/dinosaure/unstrctrd
uri	github.com/mirage/ocaml-uri
usb	github.com/letoh/ocaml-usb
usbmux	github.com/onlinemediagroup/ocaml-usbmux
user-agent-parser	github.com/issuu/uap-ocaml
user-setup	github.com/OCamlPro/opam-user-setup
utop	github.com/ocaml-community/utop
utp	www.github.com/nojb/ocaml-utp
uuidm	erratique.ch/repos/uuidm
uuseg	erratique.ch/repos/uuseg
uuuu	github.com/mirage/uuuu
uwt	github.com/fdopen/uwt
valentine	github.com/fxfactorial/valentine
variantslib	github.com/janestreet/variantslib
varint	github.com/XnuKernPoll/ocaml-varint
vcaml	github.com/janestreet/vcaml
vcardgen	github.com/vzaliva/vcardgen
vchan	github.com/mirage/ocaml-vchan
vec	github.com/aionescu/vec
vecosek	gitlab.com/smondet/vecosek
vg	erratique.ch/repos/vg
vimebac	gitlab.com/smondet/vimebac
virtual_dom	github.com/janestreet/virtual_dom
visitors	gitlab.inria.fr/fpottier/visitors
vlq	github.com/flowtype/ocaml-vlq
vmnet	github.com/mirage/ocaml-vmnet
voaacenc	github.com/savonet/ocaml-voaacenc
volt	github.com/codinuum/volt
voqc	github.com/inQWIRE/mlvoqc
vorbis	github.com/savonet/ocaml-vorbis
vpnkit	github.com/moby/vpnkit
vue-jsoo	gitlab.com/o-labs/vue-jsoo
wall	github.com/let-def/wall
wamp	github.com/vbmithr/ocaml-wamp
wasm	github.com/WebAssembly/spec
wasmtime	github.com/LaurentMazare/ocaml-wasmtime
wayland	github.com/talex5/ocaml-wayland
waylaunch	github.com/kit-ty-kate/waylaunch
wcs	github.com/IBM/wcs-ocaml
weberizer	github.com/Chris00/weberizer
webidl	github.com/0zat/webidl
webmachine	github.com/inhabitedtype/ocaml-webmachine
websocketaf	github.com/inhabitedtype/websocketaf
websocket-async	github.com/vbmithr/ocaml-websocket
websocketml	github.com/ismailbennani/websocketml
why	scm.gforge.inria.fr/anonscm/git/why/why
why3	gitlab.inria.fr/why3/why3
wikitext	github.com/geneanet/ocaml-wikitext
win-error	github.com/mirage/ocaml-win-error
win-eventlog	github.com/mirage/ocaml-win-eventlog
winsvc	github.com/savonet/ocaml-winsvc
ws	github.com/dozzman/ws
ws-server	github.com/roddyyaga/ws-server
wtf8	github.com/flowtype/ocaml-wtf8
wxOCaml	github.com/OCamlPro/ocplib-wxOCaml
x509	github.com/mirleft/ocaml-x509
xapi-libs-transitional	github.com/xapi-project/xen-api-libs-transitional
xapi-rrd	github.com/xapi-project/xcp-rrd
xapi-rrdd	github.com/xapi-project/xcp-rrdd
xapi-rrd-transport	github.com/xapi-project/rrd-transport
xenctrl	github.com/xapi-project/ocaml-xen-lowlevel-libs
xen-evtchn	github.com/mirage/ocaml-evtchn
xen-gnt	github.com/mirage/ocaml-gnt
xenstore	github.com/mirage/ocaml-xenstore
xmlplaylist	github.com/savonet/ocaml-xmlplaylist
yara	github.com/XVilka/yara-ocaml
yices2	github.com/maelvalais/ocamlyices2
yojson	github.com/ocaml-community/yojson
yurt	github.com/zshipko/yurt
yuscii	github.com/mirage/yuscii
yuujinchou	github.com/favonia/yuujinchou
z3	github.com/Z3prover/z3
zarith	github.com/ocaml/Zarith
zarith-ppx	github.com/Drup/Zarith-ppx
zarith_stubs_js	github.com/janestreet/zarith_stubs_js
zeit	github.com/emillon/ocaml-zeit
zelus	github.com/INRIA/zelus
zenon	github.com/zenon-prover/zenon
zlib	github.com/madroach/ocaml-zlib
zlist	github.com/hakuch/zlist
zstandard	github.com/janestreet/zstandard
zxcvbn	github.com/cryptosense/ocaml-zxcvbn
